5 5
0 0
4 4
1 2 3 4 5
1 2 3 4 5
1 2 0 0 0
1 2 0 1 5
1 2 1 3 5