10 10
1 1
8 8
1 2 3 4 5 4 3 5 5 2
1 2 3 4 0 4 3 5 4 2
1 2 0 0 4 5 5 5 4 2
1 2 2 1 5 1 0 5 5 2
1 2 0 0 5 0 0 5 6 2
1 2 0 5 5 0 0 5 1 2
1 2 3 0 5 0 3 5 1 2
1 2 3 1 5 0 3 5 2 2
1 2 3 0 5 0 3 5 1 2
1 2 3 4 5 4 3 5 5 2