20 20
2 10
10 15
1 2 3 4 5 4 3 5 5 2 1 2 3 4 5 4 3 5 5 2
1 2 3 4 5 4 3 5 5 2 1 2 3 4 5 4 3 5 5 2
1 2 3 4 5 4 3 5 5 2 1 2 3 4 5 4 3 5 5 2
1 2 3 4 5 4 3 5 5 2 1 2 3 4 5 4 3 5 5 2
1 2 3 4 5 4 3 5 5 2 1 2 3 4 5 4 3 5 5 2
1 2 3 4 5 4 3 5 5 2 1 2 3 4 5 4 3 5 5 2
1 2 3 4 5 4 3 5 5 2 1 0 3 4 5 4 3 5 5 2
1 2 3 4 5 4 3 5 5 2 1 2 3 4 5 4 3 5 5 2
1 2 3 4 5 4 3 5 5 2 1 2 3 4 5 4 3 5 5 2
1 2 3 4 5 4 3 5 0 2 0 2 3 4 5 4 3 5 5 2
1 2 3 4 5 4 3 5 5 2 1 2 3 4 5 4 3 5 5 2
1 2 3 4 5 4 3 5 5 2 1 2 3 4 5 4 3 5 5 2
1 2 3 4 5 4 3 5 5 2 1 2 3 4 5 4 3 5 5 2
1 2 3 4 5 4 3 5 5 2 1 2 3 4 5 4 3 5 5 2
1 2 3 4 5 4 3 5 5 2 1 2 3 4 5 4 3 5 5 2
1 2 3 4 5 4 3 5 5 2 1 2 3 4 5 4 3 5 5 2
1 2 3 4 5 4 3 5 5 2 1 2 3 4 5 4 3 5 5 2
1 2 3 4 5 4 3 5 5 2 1 2 3 4 5 4 3 5 5 2
1 2 3 4 5 4 3 5 5 2 1 2 3 4 5 4 3 5 5 2
1 2 3 4 5 4 3 5 5 2 1 2 3 4 5 4 3 5 5 2